21 21
#####################
#                   #
####### ########### #
#       #     # #   #
# ### ### ### # #####
# #   #     # # # # #
# # ### ##### # # # #
# #   # #     # # # #
####### # ##### # # #
#       # #   #   # #
# ####### ### # ### #
#       #   # # #   #
### ##### # # # # # #
#   #   # # # # # # #
# ### # ### # # # # #
# # # #     # #   # #
# # # ####### ##### #
#   #     #   #   # #
######### # # # # # #
#         # #   #    
#####################
