21 21
#####################
# #     #       #   #
# # ### # ### # # # #
# #   #   # # # # # #
# ### ##### # # ### #
#   # #   # # #   # #
### # # # # # ### # #
#   #   # # # # #   #
# ####### # # # ### #
#     #   # # # #   #
# ### # ### # # # ###
# # # #     # # # # #
# # # # ##### # # # #
# # # # #   # # # # #
# # # # # # # # # # #
#   #   # #   # #   #
# ####### ##### ### #
# #   #   #       # #
### # # ### ### ### #
#   #   #     #      
#####################
